+---+---+---+---+---+
|                   |
+   +   +   +   +   +
|                   |
+---+   +   +   +   +
|       |           |
+   +   +   +   +   +
|   |               |
+   +   +   +   +   +
|   |               |
+---+---+---+---+---+