+---+---+---+---+---+
|                   |
+---+---+---+   +---+
|                   |
+   +   +---+---+---+
|       |           |
+   +   +---+---+   +
|                   |
+---+---+---+   +   +
|               |   |
+---+---+---+---+---+