+---+---+---+---+---+
|   |   |           |
+   +   +   +   +   +
|       |   |       |
+   +   +   +   +---+
|   |   |   |       |
+   +   +---+   +   +
|   |           |   |
+   +   +   +   +   +
|   |           |   |
+---+---+---+---+---+