+---+---+---+---+---+
|   |           |   |
+   +   +   +   +   +
|   |           |   |
+   +   +---+   +   +
|       |   |   |   |
+---+   +   +   +   +
|       |   |       |
+   +   +   +   +   +
|           |   |   |
+---+---+---+---+---+