+---+---+---+---+---+
|       |           |
+   +   +   +---+---+
|                   |
+   +---+---+   +   +
|           |       |
+---+---+---+   +   +
|                   |
+---+   +---+---+---+
|                   |
+---+---+---+---+---+