+---+---+---+---+---+---+---+---+---+
|                                   |
+   +   +   +   +   +   +   +   +   +
|       |               |           |
+   +   +   +   +   +   +   +   +   +
|       |       |       |           |
+   +   +   +   +   +   +   +   +   +
|               |                   |
+   +   +   +   +   +   +   +   +   +
|       |               |           |
+   +   +   +   +   +   +   +   +   +
|       |       |       |           |
+   +   +   +   +   +   +   +   +   +
|               |                   |
+   +   +   +   +   +   +   +   +   +
|       |               |           |
+   +   +   +   +   +   +   +   +   +
|                                   |
+---+---+---+---+---+---+---+---+---+